ErrorFlag	ErrorFlag
bm_pattern_number bm_pattern_number
mps_counter mps_counter
fgx1.hw_sum fgx1
fgx2.hw_sum fgx2
fgy1.hw_sum fgy1
fgy2.hw_sum fgy2
fge.hw_sum fge
ramp.hw_sum	ramp
lemx1.hw_sum lemx1
lemx2.hw_sum lemx2
lemy1.hw_sum lemy1
lemy2.hw_sum lemy2
ramp.block0 ramp_block0
ramp.block1 ramp_block1
ramp.block2 ramp_block2
ramp.block3 ramp_block3
qwk_charge.hw_sum	qwk_charge
qwk_bcm1.hw_sum	qwk_bcm1
qwk_bcm2.hw_sum	qwk_bcm2
qwk_bcm5.hw_sum	qwk_bcm5
qwk_bcm6.hw_sum	qwk_bcm6
qwk_targetX.hw_sum	qwk_targetX
qwk_targetY.hw_sum	qwk_targetY
qwk_targetXSlope.hw_sum	qwk_targetXSlope
qwk_targetYSlope.hw_sum	qwk_targetYSlope
qwk_target_plus4X.hw_sum	qwk_target_plus4X
qwk_target_plus4Y.hw_sum	qwk_target_plus4Y
qwk_target_plus4XSlope.hw_sum	qwk_target_plus4XSlope
qwk_target_plus4YSlope.hw_sum	qwk_target_plus4YSlope
qwk_energy.hw_sum		qwk_energy
qwk_bpm3c14X.hw_sum	qwk_bpm3c14X
qwk_bpm3c14Y.hw_sum	qwk_bpm3c14Y
qwk_bpm3h02X.hw_sum	qwk_bpm3h02X
qwk_bpm3h02Y.hw_sum	qwk_bpm3h02Y
qwk_bpm3p02aX.hw_sum	qwk_bpm3p02aX
qwk_bpm3p02aY.hw_sum	qwk_bpm3p02aY
qwk_bpm3p02bX.hw_sum	qwk_bpm3p02bX
qwk_bpm3p02bY.hw_sum	qwk_bpm3p02bY
qwk_bpm3p03aX.hw_sum	qwk_bpm3p03aX
qwk_bpm3p03aY.hw_sum	qwk_bpm3p03aY
qwk_bpm3h09bX.hw_sum	qwk_bpm3h09bX
qwk_bpm3h09bY.hw_sum	qwk_bpm3h09bY
qwk_bpm3h09X.hw_sum	qwk_bpm3h09X
qwk_bpm3h09Y.hw_sum	qwk_bpm3h09Y
qwk_bpm3h04X.hw_sum	qwk_bpm3h04X
qwk_bpm3h04Y.hw_sum	qwk_bpm3h04Y
qwk_bpm3c11X.hw_sum	qwk_bpm3c11X
qwk_bpm3c12X.hw_sum	qwk_bpm3c12X
qwk_mdoddbars.hw_sum	qwk_mdoddbars
qwk_mdevenbars.hw_sum	qwk_mdevenbars
qwk_mdallbars.hw_sum	qwk_mdallbars
qwk_md1barsum.hw_sum	qwk_md1barsum
qwk_md2barsum.hw_sum	qwk_md2barsum
qwk_md3barsum.hw_sum	qwk_md3barsum
qwk_md4barsum.hw_sum	qwk_md4barsum
qwk_md5barsum.hw_sum	qwk_md5barsum
qwk_md6barsum.hw_sum	qwk_md6barsum
qwk_md7barsum.hw_sum	qwk_md7barsum
qwk_md8barsum.hw_sum	qwk_md8barsum
qwk_md9barsum.hw_sum	qwk_md9barsum
qwk_md1neg.hw_sum	qwk_md1neg
qwk_md2neg.hw_sum	qwk_md2neg
qwk_md3neg.hw_sum	qwk_md3neg
qwk_md4neg.hw_sum	qwk_md4neg
qwk_md5neg.hw_sum	qwk_md5neg
qwk_md6neg.hw_sum	qwk_md6neg
qwk_md7neg.hw_sum	qwk_md7neg
qwk_md8neg.hw_sum	qwk_md8neg
qwk_md9neg.hw_sum	qwk_md9neg
qwk_md1pos.hw_sum	qwk_md1pos
qwk_md2pos.hw_sum	qwk_md2pos
qwk_md3pos.hw_sum	qwk_md3pos
qwk_md4pos.hw_sum	qwk_md4pos
qwk_md5pos.hw_sum	qwk_md5pos
qwk_md6pos.hw_sum	qwk_md6pos
qwk_md7pos.hw_sum	qwk_md7pos
qwk_md8pos.hw_sum	qwk_md8pos
qwk_md9pos.hw_sum	qwk_md9pos
qwk_pmtonl.hw_sum	qwk_pmtonl
qwk_pmtltg.hw_sum	qwk_pmtltg
qwk_pmtled.hw_sum	qwk_pmtled
dslumi_sum.hw_sum	dslumi_sum
dslumi_odd.hw_sum	dslumi_odd
dslumi_even.hw_sum	dslumi_even
qwk_dslumi1.hw_sum	qwk_dslumi1
qwk_dslumi2.hw_sum	qwk_dslumi2
qwk_dslumi3.hw_sum	qwk_dslumi3
qwk_dslumi4.hw_sum	qwk_dslumi4
qwk_dslumi5.hw_sum	qwk_dslumi5
qwk_dslumi6.hw_sum	qwk_dslumi6
qwk_dslumi7.hw_sum	qwk_dslumi7
qwk_dslumi8.hw_sum	qwk_dslumi8
uslumi_sum.hw_sum	uslumi_sum
uslumi1_sum.hw_sum	uslumi1_sum
uslumi3_sum.hw_sum	uslumi3_sum
uslumi5_sum.hw_sum	uslumi5_sum
uslumi7_sum.hw_sum	uslumi7_sum
ramp.Device_Error_Code	ramp_Device_Error_Code
qwk_charge.Device_Error_Code	qwk_charge_Device_Error_Code
qwk_bcm1.Device_Error_Code	qwk_bcm1_Device_Error_Code
qwk_bcm2.Device_Error_Code	qwk_bcm2_Device_Error_Code
qwk_bcm5.Device_Error_Code	qwk_bcm5_Device_Error_Code
qwk_bcm6.Device_Error_Code	qwk_bcm6_Device_Error_Code
qwk_targetX.Device_Error_Code	qwk_targetX_Device_Error_Code
qwk_targetY.Device_Error_Code	qwk_targetY_Device_Error_Code
qwk_targetXSlope.Device_Error_Code qwk_targetXSlope_Device_Error_Code
qwk_targetYSlope.Device_Error_Code qwk_targetYSlope_Device_Error_Code
qwk_target_plus4X.Device_Error_Code	qwk_target_plus4X_Device_Error_Code
qwk_target_plus4Y.Device_Error_Code	qwk_target_plus4Y_Device_Error_Code
qwk_target_plus4XSlope.Device_Error_Code qwk_target_plus4XSlope_Device_Error_Code
qwk_target_plus4YSlope.Device_Error_Code qwk_target_plus4YSlope_Device_Error_Code
qwk_energy.Device_Error_Code	qwk_energy_Device_Error_Code
qwk_bpm3c14X.Device_Error_Code	qwk_bpm3c14X_Device_Error_Code
qwk_bpm3c14Y.Device_Error_Code	qwk_bpm3c14Y_Device_Error_Code
qwk_bpm3h02X.Device_Error_Code	qwk_bpm3h02X_Device_Error_Code
qwk_bpm3h02Y.Device_Error_Code	qwk_bpm3h02Y_Device_Error_Code
qwk_bpm3p02aX.Device_Error_Code	qwk_bpm3p02aX_Device_Error_Code
qwk_bpm3p02aY.Device_Error_Code	qwk_bpm3p02aY_Device_Error_Code
qwk_bpm3p02bX.Device_Error_Code	qwk_bpm3p02bX_Device_Error_Code
qwk_bpm3p02bY.Device_Error_Code	qwk_bpm3p02bY_Device_Error_Code
qwk_bpm3p03aX.Device_Error_Code	qwk_bpm3p03aX_Device_Error_Code
qwk_bpm3p03aY.Device_Error_Code	qwk_bpm3p03aY_Device_Error_Code
qwk_bpm3h09bX.Device_Error_Code	qwk_bpm3h09bX_Device_Error_Code
qwk_bpm3h09bY.Device_Error_Code	qwk_bpm3h09bY_Device_Error_Code
qwk_bpm3h09X.Device_Error_Code	qwk_bpm3h09X_Device_Error_Code
qwk_bpm3h09Y.Device_Error_Code	qwk_bpm3h09Y_Device_Error_Code
qwk_bpm3h04X.Device_Error_Code	qwk_bpm3h04X_Device_Error_Code
qwk_bpm3h04Y.Device_Error_Code	qwk_bpm3h04Y_Device_Error_Code
qwk_bpm3c11X.Device_Error_Code	qwk_bpm3c11X_Device_Error_Code
qwk_bpm3c12X.Device_Error_Code	qwk_bpm3c12X_Device_Error_Code
qwk_mdoddbars.Device_Error_Code	qwk_mdoddbars_Device_Error_Code
qwk_mdevenbars.Device_Error_Code	qwk_mdevenbars_Device_Error_Code
qwk_mdallbars.Device_Error_Code	qwk_mdallbars_Device_Error_Code
qwk_md1barsum.Device_Error_Code	qwk_md1barsum_Device_Error_Code
qwk_md2barsum.Device_Error_Code	qwk_md2barsum_Device_Error_Code
qwk_md3barsum.Device_Error_Code	qwk_md3barsum_Device_Error_Code
qwk_md4barsum.Device_Error_Code	qwk_md4barsum_Device_Error_Code
qwk_md5barsum.Device_Error_Code	qwk_md5barsum_Device_Error_Code
qwk_md6barsum.Device_Error_Code	qwk_md6barsum_Device_Error_Code
qwk_md7barsum.Device_Error_Code	qwk_md7barsum_Device_Error_Code
qwk_md8barsum.Device_Error_Code	qwk_md8barsum_Device_Error_Code
qwk_md9barsum.Device_Error_Code	qwk_md9barsum_Device_Error_Code
qwk_md1neg.Device_Error_Code	qwk_md1neg_Device_Error_Code
qwk_md2neg.Device_Error_Code	qwk_md2neg_Device_Error_Code
qwk_md3neg.Device_Error_Code	qwk_md3neg_Device_Error_Code
qwk_md4neg.Device_Error_Code	qwk_md4neg_Device_Error_Code
qwk_md5neg.Device_Error_Code	qwk_md5neg_Device_Error_Code
qwk_md6neg.Device_Error_Code	qwk_md6neg_Device_Error_Code
qwk_md7neg.Device_Error_Code	qwk_md7neg_Device_Error_Code
qwk_md8neg.Device_Error_Code	qwk_md8neg_Device_Error_Code
qwk_md9neg.Device_Error_Code	qwk_md9neg_Device_Error_Code
qwk_md1pos.Device_Error_Code	qwk_md1pos_Device_Error_Code
qwk_md2pos.Device_Error_Code	qwk_md2pos_Device_Error_Code
qwk_md3pos.Device_Error_Code	qwk_md3pos_Device_Error_Code
qwk_md4pos.Device_Error_Code	qwk_md4pos_Device_Error_Code
qwk_md5pos.Device_Error_Code	qwk_md5pos_Device_Error_Code
qwk_md6pos.Device_Error_Code	qwk_md6pos_Device_Error_Code
qwk_md7pos.Device_Error_Code	qwk_md7pos_Device_Error_Code
qwk_md8pos.Device_Error_Code	qwk_md8pos_Device_Error_Code
qwk_md9pos.Device_Error_Code	qwk_md9pos_Device_Error_Code
qwk_pmtonl.Device_Error_Code	qwk_pmtonl_Device_Error_Code
qwk_pmtltg.Device_Error_Code	qwk_pmtltg_Device_Error_Code
qwk_pmtled.Device_Error_Code	qwk_pmtled_Device_Error_Code
dslumi_sum.Device_Error_Code	dslumi_sum_Device_Error_Code
dslumi_odd.Device_Error_Code	dslumi_odd_Device_Error_Code
dslumi_even.Device_Error_Code	dslumi_even_Device_Error_Code
qwk_dslumi1.Device_Error_Code	qwk_dslumi1_Device_Error_Code
qwk_dslumi2.Device_Error_Code	qwk_dslumi2_Device_Error_Code
qwk_dslumi3.Device_Error_Code	qwk_dslumi3_Device_Error_Code
qwk_dslumi4.Device_Error_Code	qwk_dslumi4_Device_Error_Code
qwk_dslumi5.Device_Error_Code	qwk_dslumi5_Device_Error_Code
qwk_dslumi6.Device_Error_Code	qwk_dslumi6_Device_Error_Code
qwk_dslumi7.Device_Error_Code	qwk_dslumi7_Device_Error_Code
qwk_dslumi8.Device_Error_Code	qwk_dslumi8_Device_Error_Code
uslumi_sum.Device_Error_Code	uslumi_sum_Device_Error_Code
uslumi1_sum.Device_Error_Code	uslumi1_sum_Device_Error_Code
uslumi3_sum.Device_Error_Code	uslumi3_sum_Device_Error_Code
uslumi5_sum.Device_Error_Code	uslumi5_sum_Device_Error_Code
uslumi7_sum.Device_Error_Code	uslumi7_sum_Device_Error_Code
