ErrorFlag	ErrorFlag
actual_pattern_polarity	actual_pattern_polarity
actual_previous_pattern_polarity	actual_previous_pattern_polarity
delayed_pattern_polarity	delayed_pattern_polarity
yield_ramp.hw_sum	yield_ramp
yield_qwk_charge.hw_sum	yield_qwk_charge
yield_qwk_bcm1.hw_sum	yield_qwk_bcm1
yield_qwk_bcm2.hw_sum	yield_qwk_bcm2
yield_qwk_bcm5.hw_sum	yield_qwk_bcm5
yield_qwk_bcm6.hw_sum	yield_qwk_bcm6
yield_qwk_targetX.hw_sum	yield_qwk_targetX
yield_qwk_targetY.hw_sum	yield_qwk_targetY
yield_qwk_targetXSlope.hw_sum	yield_qwk_targetXSlope
yield_qwk_targetYSlope.hw_sum	yield_qwk_targetYSlope
yield_qwk_energy.hw_sum	yield_qwk_energy
yield_qwk_bpm3h09bX.hw_sum	yield_qwk_bpm3h09bX
yield_qwk_bpm3h09bY.hw_sum	yield_qwk_bpm3h09bY
yield_qwk_bpm3h04X.hw_sum	yield_qwk_bpm3h04X
yield_qwk_bpm3h04Y.hw_sum	yield_qwk_bpm3h04Y
yield_qwk_bpm3c12X.hw_sum	yield_qwk_bpm3c12X
yield_qwk_mdoddbars.hw_sum	yield_qwk_mdoddbars
yield_qwk_mdevenbars.hw_sum	yield_qwk_mdevenbars
yield_qwk_mdallbars.hw_sum	yield_qwk_mdallbars
yield_qwk_mdallbarsavg.hw_sum	yield_qwk_mdallbarsavg
yield_qwk_mdallpmtavg.hw_sum	yield_qwk_mdallpmtavh
yield_qwk_md1barsum.hw_sum	yield_qwk_md1barsum
yield_qwk_md2barsum.hw_sum	yield_qwk_md2barsum
yield_qwk_md3barsum.hw_sum	yield_qwk_md3barsum
yield_qwk_md4barsum.hw_sum	yield_qwk_md4barsum
yield_qwk_md5barsum.hw_sum	yield_qwk_md5barsum
yield_qwk_md6barsum.hw_sum	yield_qwk_md6barsum
yield_qwk_md7barsum.hw_sum	yield_qwk_md7barsum
yield_qwk_md8barsum.hw_sum	yield_qwk_md8barsum
yield_qwk_md9barsum.hw_sum	yield_qwk_md9barsum
yield_qwk_md1neg.hw_sum	yield_qwk_md1neg
yield_qwk_md2neg.hw_sum	yield_qwk_md2neg
yield_qwk_md3neg.hw_sum	yield_qwk_md3neg
yield_qwk_md4neg.hw_sum	yield_qwk_md4neg
yield_qwk_md5neg.hw_sum	yield_qwk_md5neg
yield_qwk_md6neg.hw_sum	yield_qwk_md6neg
yield_qwk_md7neg.hw_sum	yield_qwk_md7neg
yield_qwk_md8neg.hw_sum	yield_qwk_md8neg
yield_qwk_md9neg.hw_sum	yield_qwk_md9neg
yield_qwk_md1pos.hw_sum	yield_qwk_md1pos
yield_qwk_md2pos.hw_sum	yield_qwk_md2pos
yield_qwk_md3pos.hw_sum	yield_qwk_md3pos
yield_qwk_md4pos.hw_sum	yield_qwk_md4pos
yield_qwk_md5pos.hw_sum	yield_qwk_md5pos
yield_qwk_md6pos.hw_sum	yield_qwk_md6pos
yield_qwk_md7pos.hw_sum	yield_qwk_md7pos
yield_qwk_md8pos.hw_sum	yield_qwk_md8pos
yield_qwk_md9pos.hw_sum	yield_qwk_md9pos
yield_qwk_pmtonl.hw_sum	yield_qwk_pmtonl
yield_qwk_pmtltg.hw_sum	yield_qwk_pmtltg
yield_qwk_pmtled.hw_sum	yield_qwk_pmtled
yield_qwk_isourc.hw_sum	yield_qwk_isourc
yield_qwk_cagesr.hw_sum	yield_qwk_cagesr
yield_qwk_preamp.hw_sum	yield_qwk_preamp
yield_qwk_linephase.hw_sum	yield_qwk_linephase
yield_qwk_raster_x.hw_sum	yield_qwk_raster_x
yield_qwk_raster_y.hw_sum	yield_qwk_raster_y
yield_qwk_raster_sumxy.hw_sum	yield_qwk_raster_sumxy
yield_dslumi_sum.hw_sum	yield_dslumi_sum
yield_dslumi_odd.hw_sum	yield_dslumi_odd
yield_dslumi_even.hw_sum	yield_dslumi_even
yield_qwk_dslumi1.hw_sum	yield_qwk_dslumi1
yield_qwk_dslumi2.hw_sum	yield_qwk_dslumi2
yield_qwk_dslumi3.hw_sum	yield_qwk_dslumi3
yield_qwk_dslumi4.hw_sum	yield_qwk_dslumi4
yield_qwk_dslumi5.hw_sum	yield_qwk_dslumi5
yield_qwk_dslumi6.hw_sum	yield_qwk_dslumi6
yield_qwk_dslumi7.hw_sum	yield_qwk_dslumi7
yield_qwk_dslumi8.hw_sum	yield_qwk_dslumi8
yield_uslumi_sum.hw_sum	yield_uslumi_sum
yield_uslumi1_sum.hw_sum	yield_uslumi1_sum
yield_uslumi3_sum.hw_sum	yield_uslumi3_sum
yield_uslumi5_sum.hw_sum	yield_uslumi5_sum
yield_uslumi7_sum.hw_sum	yield_uslumi7_sum
yield_qwk_uslumi1neg.hw_sum	yield_qwk_uslumi1neg
yield_qwk_uslumi3neg.hw_sum	yield_qwk_uslumi3neg
yield_qwk_uslumi5neg.hw_sum	yield_qwk_uslumi5neg
yield_qwk_uslumi7neg.hw_sum	yield_qwk_uslumi7neg
yield_qwk_uslumi1pos.hw_sum	yield_qwk_uslumi1pos
yield_qwk_uslumi3pos.hw_sum	yield_qwk_uslumi3pos
yield_qwk_uslumi5pos.hw_sum	yield_qwk_uslumi5pos
yield_qwk_uslumi7pos.hw_sum	yield_qwk_uslumi7pos
asym_qwk_charge.hw_sum	asym_qwk_charge
asym_qwk_bcm1.hw_sum	asym_qwk_bcm1
asym_qwk_bcm2.hw_sum	asym_qwk_bcm2
asym_qwk_bcm5.hw_sum	asym_qwk_bcm5
asym_qwk_bcm6.hw_sum	asym_qwk_bcm6
diff_qwk_targetX.hw_sum	diff_qwk_targetX
diff_qwk_targetY.hw_sum	diff_qwk_targetY
diff_qwk_targetXSlope.hw_sum	diff_qwk_targetXSlope
diff_qwk_targetYSlope.hw_sum	diff_qwk_targetYSlope
diff_qwk_energy.hw_sum	diff_qwk_energy
diff_qwk_bpm3h09bX.hw_sum	diff_qwk_bpm3h09bX
diff_qwk_bpm3h09bY.hw_sum	diff_qwk_bpm3h09bY
diff_qwk_bpm3h04X.hw_sum	diff_qwk_bpm3h04X
diff_qwk_bpm3h04Y.hw_sum	diff_qwk_bpm3h04Y
diff_qwk_bpm3c12X.hw_sum	diff_qwk_bpm3c12X
asym_qwk_mdoddbars.hw_sum	asym_qwk_mdoddbars
asym_qwk_mdevenbars.hw_sum	asym_qwk_mdevenbars
asym_qwk_mdallbars.hw_sum	asym_qwk_mdallbars
asym_qwk_mdallbarsavg.hw_sum	asym_qwk_mdallbarsavg
asym_qwk_mdallpmtavg.hw_sum	asym_qwk_mdallpmtavg
asym_qwk_md1barsum.hw_sum	asym_qwk_md1barsum
asym_qwk_md2barsum.hw_sum	asym_qwk_md2barsum
asym_qwk_md3barsum.hw_sum	asym_qwk_md3barsum
asym_qwk_md4barsum.hw_sum	asym_qwk_md4barsum
asym_qwk_md5barsum.hw_sum	asym_qwk_md5barsum
asym_qwk_md6barsum.hw_sum	asym_qwk_md6barsum
asym_qwk_md7barsum.hw_sum	asym_qwk_md7barsum
asym_qwk_md8barsum.hw_sum	asym_qwk_md8barsum
asym_qwk_md9barsum.hw_sum	asym_qwk_md9barsum
asym_qwk_md1neg.hw_sum	asym_qwk_md1neg
asym_qwk_md2neg.hw_sum	asym_qwk_md2neg
asym_qwk_md3neg.hw_sum	asym_qwk_md3neg
asym_qwk_md4neg.hw_sum	asym_qwk_md4neg
asym_qwk_md5neg.hw_sum	asym_qwk_md5neg
asym_qwk_md6neg.hw_sum	asym_qwk_md6neg
asym_qwk_md7neg.hw_sum	asym_qwk_md7neg
asym_qwk_md8neg.hw_sum	asym_qwk_md8neg
asym_qwk_md9neg.hw_sum	asym_qwk_md9neg
asym_qwk_md1pos.hw_sum	asym_qwk_md1pos
asym_qwk_md2pos.hw_sum	asym_qwk_md2pos
asym_qwk_md3pos.hw_sum	asym_qwk_md3pos
asym_qwk_md4pos.hw_sum	asym_qwk_md4pos
asym_qwk_md5pos.hw_sum	asym_qwk_md5pos
asym_qwk_md6pos.hw_sum	asym_qwk_md6pos
asym_qwk_md7pos.hw_sum	asym_qwk_md7pos
asym_qwk_md8pos.hw_sum	asym_qwk_md8pos
asym_qwk_md9pos.hw_sum	asym_qwk_md9pos
asym_qwk_pmtonl.hw_sum	asym_qwk_pmtonl
asym_qwk_pmtltg.hw_sum	asym_qwk_pmtltg
asym_qwk_pmtled.hw_sum	asym_qwk_pmtled
asym_qwk_isourc.hw_sum	asym_qwk_isourc
asym_qwk_cagesr.hw_sum	asym_qwk_cagesr
asym_qwk_preamp.hw_sum	asym_qwk_preamp
asym_qwk_linephase.hw_sum	asym_qwk_linephase
diff_qwk_raster_x.hw_sum	diff_qwk_raster_x
diff_qwk_raster_y.hw_sum	diff_qwk_raster_y
diff_qwk_raster_sumxy.hw_sum	diff_qwk_raster_sumxy
asym_dslumi_sum.hw_sum	asym_dslumi_sum
asym_dslumi_odd.hw_sum	asym_dslumi_odd
asym_dslumi_even.hw_sum	asym_dslumi_even
asym_qwk_dslumi1.hw_sum	asym_qwk_dslumi1
asym_qwk_dslumi2.hw_sum	asym_qwk_dslumi2
asym_qwk_dslumi3.hw_sum	asym_qwk_dslumi3
asym_qwk_dslumi4.hw_sum	asym_qwk_dslumi4
asym_qwk_dslumi5.hw_sum	asym_qwk_dslumi5
asym_qwk_dslumi6.hw_sum	asym_qwk_dslumi6
asym_qwk_dslumi7.hw_sum	asym_qwk_dslumi7
asym_qwk_dslumi8.hw_sum	asym_qwk_dslumi8
asym_uslumi_sum.hw_sum	asym_uslumi_sum
asym_uslumi1_sum.hw_sum	asym_uslumi1_sum
asym_uslumi3_sum.hw_sum	asym_uslumi3_sum
asym_uslumi5_sum.hw_sum	asym_uslumi5_sum
asym_uslumi7_sum.hw_sum	asym_uslumi7_sum
asym_qwk_uslumi1neg.hw_sum	asym_qwk_uslumi1neg
asym_qwk_uslumi3neg.hw_sum	asym_qwk_uslumi3neg
asym_qwk_uslumi5neg.hw_sum	asym_qwk_uslumi5neg
asym_qwk_uslumi7neg.hw_sum	asym_qwk_uslumi7neg
asym_qwk_uslumi1pos.hw_sum	asym_qwk_uslumi1pos
asym_qwk_uslumi3pos.hw_sum	asym_qwk_uslumi3pos
asym_qwk_uslumi5pos.hw_sum	asym_qwk_uslumi5pos
asym_qwk_uslumi7pos.hw_sum	asym_qwk_uslumi7pos
asym1_qwk_charge.hw_sum	asym1_qwk_charge
asym1_qwk_bcm1.hw_sum	asym1_qwk_bcm1
asym1_qwk_bcm2.hw_sum	asym1_qwk_bcm2
asym1_qwk_bcm5.hw_sum	asym1_qwk_bcm5
asym1_qwk_bcm6.hw_sum	asym1_qwk_bcm6
asym1_qwk_targetX.hw_sum	asym1_qwk_targetX
asym1_qwk_targetY.hw_sum	asym1_qwk_targetY
asym1_qwk_targetXSlope.hw_sum	asym1_qwk_targetXSlope
asym1_qwk_targetYSlope.hw_sum	asym1_qwk_targetYSlope
asym1_qwk_energy.hw_sum	asym1_qwk_energy
asym1_qwk_bpm3h09bX.hw_sum	asym1_qwk_bpm3h09bX
asym1_qwk_bpm3h09bY.hw_sum	asym1_qwk_bpm3h09bY
asym1_qwk_bpm3h04X.hw_sum	asym1_qwk_bpm3h04X
asym1_qwk_bpm3h04Y.hw_sum	asym1_qwk_bpm3h04Y
asym1_qwk_bpm3c12X.hw_sum	asym1_qwk_bpm3c12X
asym1_qwk_mdoddbars.hw_sum	asym1_qwk_mdoddbars
asym1_qwk_mdevenbars.hw_sum	asym1_qwk_mdevenbars
asym1_qwk_mdallbars.hw_sum	asym1_qwk_mdallbars
asym1_qwk_mdallbarsavg.hw_sum	asym1_qwk_mdallbarsavg
asym1_qwk_mdallpmtavg.hw_sum	asym1_qwk_mdallpmtavg
asym1_qwk_md1barsum.hw_sum	asym1_qwk_md1barsum
asym1_qwk_md2barsum.hw_sum	asym1_qwk_md2barsum
asym1_qwk_md3barsum.hw_sum	asym1_qwk_md3barsum
asym1_qwk_md4barsum.hw_sum	asym1_qwk_md4barsum
asym1_qwk_md5barsum.hw_sum	asym1_qwk_md5barsum
asym1_qwk_md6barsum.hw_sum	asym1_qwk_md6barsum
asym1_qwk_md7barsum.hw_sum	asym1_qwk_md7barsum
asym1_qwk_md8barsum.hw_sum	asym1_qwk_md8barsum
asym1_qwk_md9barsum.hw_sum	asym1_qwk_md9barsum
asym1_qwk_md1neg.hw_sum	asym1_qwk_md1neg
asym1_qwk_md2neg.hw_sum	asym1_qwk_md2neg
asym1_qwk_md3neg.hw_sum	asym1_qwk_md3neg
asym1_qwk_md4neg.hw_sum	asym1_qwk_md4neg
asym1_qwk_md5neg.hw_sum	asym1_qwk_md5neg
asym1_qwk_md6neg.hw_sum	asym1_qwk_md6neg
asym1_qwk_md7neg.hw_sum	asym1_qwk_md7neg
asym1_qwk_md8neg.hw_sum	asym1_qwk_md8neg
asym1_qwk_md9neg.hw_sum	asym1_qwk_md9neg
asym1_qwk_md1pos.hw_sum	asym1_qwk_md1pos
asym1_qwk_md2pos.hw_sum	asym1_qwk_md2pos
asym1_qwk_md3pos.hw_sum	asym1_qwk_md3pos
asym1_qwk_md4pos.hw_sum	asym1_qwk_md4pos
asym1_qwk_md5pos.hw_sum	asym1_qwk_md5pos
asym1_qwk_md6pos.hw_sum	asym1_qwk_md6pos
asym1_qwk_md7pos.hw_sum	asym1_qwk_md7pos
asym1_qwk_md8pos.hw_sum	asym1_qwk_md8pos
asym1_qwk_md9pos.hw_sum	asym1_qwk_md9pos
asym1_qwk_pmtonl.hw_sum	asym1_qwk_pmtonl
asym1_qwk_pmtltg.hw_sum	asym1_qwk_pmtltg
asym1_qwk_pmtled.hw_sum	asym1_qwk_pmtled
asym1_qwk_isourc.hw_sum	asym1_qwk_isourc
asym1_qwk_cagesr.hw_sum	asym1_qwk_cagesr
asym1_qwk_preamp.hw_sum	asym1_qwk_preamp
asym1_qwk_linephase.hw_sum	asym1_qwk_linephase
asym1_qwk_raster_x.hw_sum	asym1_qwk_raster_x
asym1_qwk_raster_y.hw_sum	asym1_qwk_raster_y
asym1_qwk_raster_sumxy.hw_sum	asym1_qwk_raster_sumxy
asym1_dslumi_sum.hw_sum	asym1_dslumi_sum
asym1_dslumi_odd.hw_sum	asym1_dslumi_odd
asym1_dslumi_even.hw_sum	asym1_dslumi_even
asym1_qwk_dslumi1.hw_sum	asym1_qwk_dslumi1
asym1_qwk_dslumi2.hw_sum	asym1_qwk_dslumi2
asym1_qwk_dslumi3.hw_sum	asym1_qwk_dslumi3
asym1_qwk_dslumi4.hw_sum	asym1_qwk_dslumi4
asym1_qwk_dslumi5.hw_sum	asym1_qwk_dslumi5
asym1_qwk_dslumi6.hw_sum	asym1_qwk_dslumi6
asym1_qwk_dslumi7.hw_sum	asym1_qwk_dslumi7
asym1_qwk_dslumi8.hw_sum	asym1_qwk_dslumi8
asym1_uslumi_sum.hw_sum	asym1_uslumi_sum
asym1_uslumi1_sum.hw_sum	asym1_uslumi1_sum
asym1_uslumi3_sum.hw_sum	asym1_uslumi3_sum
asym1_uslumi5_sum.hw_sum	asym1_uslumi5_sum
asym1_uslumi7_sum.hw_sum	asym1_uslumi7_sum
asym1_qwk_uslumi1neg.hw_sum	asym1_qwk_uslumi1neg
asym1_qwk_uslumi3neg.hw_sum	asym1_qwk_uslumi3neg
asym1_qwk_uslumi5neg.hw_sum	asym1_qwk_uslumi5neg
asym1_qwk_uslumi7neg.hw_sum	asym1_qwk_uslumi7neg
asym1_qwk_uslumi1pos.hw_sum	asym1_qwk_uslumi1pos
asym1_qwk_uslumi3pos.hw_sum	asym1_qwk_uslumi3pos
asym1_qwk_uslumi5pos.hw_sum	asym1_qwk_uslumi5pos
asym1_qwk_uslumi7pos.hw_sum	asym1_qwk_uslumi7pos
asym2_qwk_charge.hw_sum	asym2_qwk_charge
asym2_qwk_bcm1.hw_sum	asym2_qwk_bcm1
asym2_qwk_bcm2.hw_sum	asym2_qwk_bcm2
asym2_qwk_bcm5.hw_sum	asym2_qwk_bcm5
asym2_qwk_bcm6.hw_sum	asym2_qwk_bcm6
asym2_qwk_targetX.hw_sum	asym2_qwk_targetX
asym2_qwk_targetY.hw_sum	asym2_qwk_targetY
asym2_qwk_targetXSlope.hw_sum	asym2_qwk_targetXSlope
asym2_qwk_targetYSlope.hw_sum	asym2_qwk_targetYSlope
asym2_qwk_energy.hw_sum	asym2_qwk_energy
asym2_qwk_bpm3h09bX.hw_sum	asym2_qwk_bpm3h09bX
asym2_qwk_bpm3h09bY.hw_sum	asym2_qwk_bpm3h09bY
asym2_qwk_bpm3h04X.hw_sum	asym2_qwk_bpm3h04X
asym2_qwk_bpm3h04Y.hw_sum	asym2_qwk_bpm3h04Y
asym2_qwk_bpm3c12X.hw_sum	asym2_qwk_bpm3c12X
asym2_qwk_mdoddbars.hw_sum	asym2_qwk_mdoddbars
asym2_qwk_mdevenbars.hw_sum	asym2_qwk_mdevenbars
asym2_qwk_mdallbars.hw_sum	asym2_qwk_mdallbars
asym2_qwk_mdallbarsavg.hw_sum	asym2_qwk_mdallbarsavg
asym2_qwk_mdallpmtavg.hw_sum	asym2_qwk_mdallpmtavg
asym2_qwk_md1barsum.hw_sum	asym2_qwk_md1barsum
asym2_qwk_md2barsum.hw_sum	asym2_qwk_md2barsum
asym2_qwk_md3barsum.hw_sum	asym2_qwk_md3barsum
asym2_qwk_md4barsum.hw_sum	asym2_qwk_md4barsum
asym2_qwk_md5barsum.hw_sum	asym2_qwk_md5barsum
asym2_qwk_md6barsum.hw_sum	asym2_qwk_md6barsum
asym2_qwk_md7barsum.hw_sum	asym2_qwk_md7barsum
asym2_qwk_md8barsum.hw_sum	asym2_qwk_md8barsum
asym2_qwk_md9barsum.hw_sum	asym2_qwk_md9barsum
asym2_qwk_md1neg.hw_sum	asym2_qwk_md1neg
asym2_qwk_md2neg.hw_sum	asym2_qwk_md2neg
asym2_qwk_md3neg.hw_sum	asym2_qwk_md3neg
asym2_qwk_md4neg.hw_sum	asym2_qwk_md4neg
asym2_qwk_md5neg.hw_sum	asym2_qwk_md5neg
asym2_qwk_md6neg.hw_sum	asym2_qwk_md6neg
asym2_qwk_md7neg.hw_sum	asym2_qwk_md7neg
asym2_qwk_md8neg.hw_sum	asym2_qwk_md8neg
asym2_qwk_md9neg.hw_sum	asym2_qwk_md9neg
asym2_qwk_md1pos.hw_sum	asym2_qwk_md1pos
asym2_qwk_md2pos.hw_sum	asym2_qwk_md2pos
asym2_qwk_md3pos.hw_sum	asym2_qwk_md3pos
asym2_qwk_md4pos.hw_sum	asym2_qwk_md4pos
asym2_qwk_md5pos.hw_sum	asym2_qwk_md5pos
asym2_qwk_md6pos.hw_sum	asym2_qwk_md6pos
asym2_qwk_md7pos.hw_sum	asym2_qwk_md7pos
asym2_qwk_md8pos.hw_sum	asym2_qwk_md8pos
asym2_qwk_md9pos.hw_sum	asym2_qwk_md9pos
asym2_qwk_pmtonl.hw_sum	asym2_qwk_pmtonl
asym2_qwk_pmtltg.hw_sum	asym2_qwk_pmtltg
asym2_qwk_pmtled.hw_sum	asym2_qwk_pmtled
asym2_qwk_isourc.hw_sum	asym2_qwk_isourc
asym2_qwk_cagesr.hw_sum	asym2_qwk_cagesr
asym2_qwk_preamp.hw_sum	asym2_qwk_preamp
asym2_qwk_linephase.hw_sum	asym2_qwk_linephase
asym2_qwk_raster_x.hw_sum	asym2_qwk_raster_x
asym2_qwk_raster_y.hw_sum	asym2_qwk_raster_y
asym2_qwk_raster_sumxy.hw_sum	asym2_qwk_raster_sumxy
asym2_dslumi_sum.hw_sum	asym2_dslumi_sum
asym2_dslumi_odd.hw_sum	asym2_dslumi_odd
asym2_dslumi_even.hw_sum	asym2_dslumi_even
asym2_qwk_dslumi1.hw_sum	asym2_qwk_dslumi1
asym2_qwk_dslumi2.hw_sum	asym2_qwk_dslumi2
asym2_qwk_dslumi3.hw_sum	asym2_qwk_dslumi3
asym2_qwk_dslumi4.hw_sum	asym2_qwk_dslumi4
asym2_qwk_dslumi5.hw_sum	asym2_qwk_dslumi5
asym2_qwk_dslumi6.hw_sum	asym2_qwk_dslumi6
asym2_qwk_dslumi7.hw_sum	asym2_qwk_dslumi7
asym2_qwk_dslumi8.hw_sum	asym2_qwk_dslumi8
asym2_uslumi_sum.hw_sum	asym2_uslumi_sum
asym2_uslumi1_sum.hw_sum	asym2_uslumi1_sum
asym2_uslumi3_sum.hw_sum	asym2_uslumi3_sum
asym2_uslumi5_sum.hw_sum	asym2_uslumi5_sum
asym2_uslumi7_sum.hw_sum	asym2_uslumi7_sum
asym2_qwk_uslumi1neg.hw_sum	asym2_qwk_uslumi1neg
asym2_qwk_uslumi3neg.hw_sum	asym2_qwk_uslumi3neg
asym2_qwk_uslumi5neg.hw_sum	asym2_qwk_uslumi5neg
asym2_qwk_uslumi7neg.hw_sum	asym2_qwk_uslumi7neg
asym2_qwk_uslumi1pos.hw_sum	asym2_qwk_uslumi1pos
asym2_qwk_uslumi3pos.hw_sum	asym2_qwk_uslumi3pos
asym2_qwk_uslumi5pos.hw_sum	asym2_qwk_uslumi5pos
asym2_qwk_uslumi7pos.hw_sum	asym2_qwk_uslumi7pos
yield_ramp.Device_Error_Code	yield_ramp_Device_Error_Code
yield_qwk_charge.Device_Error_Code	yield_qwk_charge_Device_Error_Code
yield_qwk_bcm1.Device_Error_Code	yield_qwk_bcm1_Device_Error_Code
yield_qwk_bcm2.Device_Error_Code	yield_qwk_bcm2_Device_Error_Code
yield_qwk_bcm5.Device_Error_Code	yield_qwk_bcm5_Device_Error_Code
yield_qwk_bcm6.Device_Error_Code	yield_qwk_bcm6_Device_Error_Code
yield_qwk_targetX.Device_Error_Code	yield_qwk_targetX_Device_Error_Code
yield_qwk_targetY.Device_Error_Code	yield_qwk_targetY_Device_Error_Code
yield_qwk_targetXSlope.Device_Error_Code	yield_qwk_targetXSlope_Device_Error_Code
yield_qwk_targetYSlope.Device_Error_Code	yield_qwk_targetYSlope_Device_Error_Code
yield_qwk_energy.Device_Error_Code	yield_qwk_energy_Device_Error_Code
yield_qwk_bpm3h09bX.Device_Error_Code	yield_qwk_bpm3h09bX_Device_Error_Code
yield_qwk_bpm3h09bY.Device_Error_Code	yield_qwk_bpm3h09bY_Device_Error_Code
yield_qwk_bpm3h04X.Device_Error_Code	yield_qwk_bpm3h04X_Device_Error_Code
yield_qwk_bpm3h04Y.Device_Error_Code	yield_qwk_bpm3h04Y_Device_Error_Code
yield_qwk_bpm3c12X.Device_Error_Code	yield_qwk_bpm3c12X_Device_Error_Code
yield_qwk_mdoddbars.Device_Error_Code	yield_qwk_mdoddbars_Device_Error_Code
yield_qwk_mdevenbars.Device_Error_Code	yield_qwk_mdevenbars_Device_Error_Code
yield_qwk_mdallbars.Device_Error_Code	yield_qwk_mdallbars_Device_Error_Code
yield_qwk_mdallbarsavg.Device_Error_Code	yield_qwk_mdallbarsavg_Device_Error_Code
yield_qwk_mdallpmtavg.Device_Error_Code	yield_qwk_mdallpmtavg_Device_Error_Code
yield_qwk_md1barsum.Device_Error_Code	yield_qwk_md1barsum_Device_Error_Code
yield_qwk_md2barsum.Device_Error_Code	yield_qwk_md2barsum_Device_Error_Code
yield_qwk_md3barsum.Device_Error_Code	yield_qwk_md3barsum_Device_Error_Code
yield_qwk_md4barsum.Device_Error_Code	yield_qwk_md4barsum_Device_Error_Code
yield_qwk_md5barsum.Device_Error_Code	yield_qwk_md5barsum_Device_Error_Code
yield_qwk_md6barsum.Device_Error_Code	yield_qwk_md6barsum_Device_Error_Code
yield_qwk_md7barsum.Device_Error_Code	yield_qwk_md7barsum_Device_Error_Code
yield_qwk_md8barsum.Device_Error_Code	yield_qwk_md8barsum_Device_Error_Code
yield_qwk_md9barsum.Device_Error_Code	yield_qwk_md9barsum_Device_Error_Code
yield_qwk_md1neg.Device_Error_Code	yield_qwk_md1neg_Device_Error_Code
yield_qwk_md2neg.Device_Error_Code	yield_qwk_md2neg_Device_Error_Code
yield_qwk_md3neg.Device_Error_Code	yield_qwk_md3neg_Device_Error_Code
yield_qwk_md4neg.Device_Error_Code	yield_qwk_md4neg_Device_Error_Code
yield_qwk_md5neg.Device_Error_Code	yield_qwk_md5neg_Device_Error_Code
yield_qwk_md6neg.Device_Error_Code	yield_qwk_md6neg_Device_Error_Code
yield_qwk_md7neg.Device_Error_Code	yield_qwk_md7neg_Device_Error_Code
yield_qwk_md8neg.Device_Error_Code	yield_qwk_md8neg_Device_Error_Code
yield_qwk_md9neg.Device_Error_Code	yield_qwk_md9neg_Device_Error_Code
yield_qwk_md1pos.Device_Error_Code	yield_qwk_md1pos_Device_Error_Code
yield_qwk_md2pos.Device_Error_Code	yield_qwk_md2pos_Device_Error_Code
yield_qwk_md3pos.Device_Error_Code	yield_qwk_md3pos_Device_Error_Code
yield_qwk_md4pos.Device_Error_Code	yield_qwk_md4pos_Device_Error_Code
yield_qwk_md5pos.Device_Error_Code	yield_qwk_md5pos_Device_Error_Code
yield_qwk_md6pos.Device_Error_Code	yield_qwk_md6pos_Device_Error_Code
yield_qwk_md7pos.Device_Error_Code	yield_qwk_md7pos_Device_Error_Code
yield_qwk_md8pos.Device_Error_Code	yield_qwk_md8pos_Device_Error_Code
yield_qwk_md9pos.Device_Error_Code	yield_qwk_md9pos_Device_Error_Code
yield_qwk_pmtonl.Device_Error_Code	yield_qwk_pmtonl_Device_Error_Code
yield_qwk_pmtltg.Device_Error_Code	yield_qwk_pmtltg_Device_Error_Code
yield_qwk_pmtled.Device_Error_Code	yield_qwk_pmtled_Device_Error_Code
yield_qwk_isourc.Device_Error_Code	yield_qwk_isourc_Device_Error_Code
yield_qwk_cagesr.Device_Error_Code	yield_qwk_cagesr_Device_Error_Code
yield_qwk_preamp.Device_Error_Code	yield_qwk_preamp_Device_Error_Code
yield_qwk_linephase.Device_Error_Code	yield_qwk_linephase_Device_Error_Code
yield_qwk_raster_x.Device_Error_Code	yield_qwk_raster_x_Device_Error_Code
yield_qwk_raster_y.Device_Error_Code	yield_qwk_raster_y_Device_Error_Code
yield_qwk_raster_sumxy.Device_Error_Code	yield_qwk_raster_sumxy_Device_Error_Code
yield_dslumi_sum.Device_Error_Code	yield_dslumi_sum_Device_Error_Code
yield_dslumi_odd.Device_Error_Code	yield_dslumi_odd_Device_Error_Code
yield_dslumi_even.Device_Error_Code	yield_dslumi_even_Device_Error_Code
yield_qwk_dslumi1.Device_Error_Code	yield_qwk_dslumi1_Device_Error_Code
yield_qwk_dslumi2.Device_Error_Code	yield_qwk_dslumi2_Device_Error_Code
yield_qwk_dslumi3.Device_Error_Code	yield_qwk_dslumi3_Device_Error_Code
yield_qwk_dslumi4.Device_Error_Code	yield_qwk_dslumi4_Device_Error_Code
yield_qwk_dslumi5.Device_Error_Code	yield_qwk_dslumi5_Device_Error_Code
yield_qwk_dslumi6.Device_Error_Code	yield_qwk_dslumi6_Device_Error_Code
yield_qwk_dslumi7.Device_Error_Code	yield_qwk_dslumi7_Device_Error_Code
yield_qwk_dslumi8.Device_Error_Code	yield_qwk_dslumi8_Device_Error_Code
yield_uslumi_sum.Device_Error_Code	yield_uslumi_sum_Device_Error_Code
yield_uslumi1_sum.Device_Error_Code	yield_uslumi1_sum_Device_Error_Code
yield_uslumi3_sum.Device_Error_Code	yield_uslumi3_sum_Device_Error_Code
yield_uslumi5_sum.Device_Error_Code	yield_uslumi5_sum_Device_Error_Code
yield_uslumi7_sum.Device_Error_Code	yield_uslumi7_sum_Device_Error_Code
yield_qwk_uslumi1neg.Device_Error_Code	yield_qwk_uslumi1neg_Device_Error_Code
yield_qwk_uslumi3neg.Device_Error_Code	yield_qwk_uslumi3neg_Device_Error_Code
yield_qwk_uslumi5neg.Device_Error_Code	yield_qwk_uslumi5neg_Device_Error_Code
yield_qwk_uslumi7neg.Device_Error_Code	yield_qwk_uslumi7neg_Device_Error_Code
yield_qwk_uslumi1pos.Device_Error_Code	yield_qwk_uslumi1pos_Device_Error_Code
yield_qwk_uslumi3pos.Device_Error_Code	yield_qwk_uslumi3pos_Device_Error_Code
yield_qwk_uslumi5pos.Device_Error_Code	yield_qwk_uslumi5pos_Device_Error_Code
yield_qwk_uslumi7pos.Device_Error_Code	yield_qwk_uslumi7pos_Device_Error_Code
asym_qwk_charge.Device_Error_Code	asym_qwk_charge_Device_Error_Code
asym_qwk_bcm1.Device_Error_Code	asym_qwk_bcm1_Device_Error_Code
asym_qwk_bcm2.Device_Error_Code	asym_qwk_bcm2_Device_Error_Code
asym_qwk_bcm5.Device_Error_Code	asym_qwk_bcm5_Device_Error_Code
asym_qwk_bcm6.Device_Error_Code	asym_qwk_bcm6_Device_Error_Code
diff_qwk_targetX.Device_Error_Code	diff_qwk_targetX_Device_Error_Code
diff_qwk_targetY.Device_Error_Code	diff_qwk_targetY_Device_Error_Code
diff_qwk_targetXSlope.Device_Error_Code	diff_qwk_targetXSlope_Device_Error_Code
diff_qwk_targetYSlope.Device_Error_Code	diff_qwk_targetYSlope_Device_Error_Code
diff_qwk_energy.Device_Error_Code	diff_qwk_energy_Device_Error_Code
diff_qwk_bpm3h09bX.Device_Error_Code	diff_qwk_bpm3h09bX_Device_Error_Code
diff_qwk_bpm3h09bY.Device_Error_Code	diff_qwk_bpm3h09bY_Device_Error_Code
diff_qwk_bpm3h04X.Device_Error_Code	diff_qwk_bpm3h04X_Device_Error_Code
diff_qwk_bpm3h04Y.Device_Error_Code	diff_qwk_bpm3h04Y_Device_Error_Code
diff_qwk_bpm3c12X.Device_Error_Code	diff_qwk_bpm3c12X_Device_Error_Code
asym_qwk_mdoddbars.Device_Error_Code	asym_qwk_mdoddbars_Device_Error_Code
asym_qwk_mdevenbars.Device_Error_Code	asym_qwk_mdevenbars_Device_Error_Code
asym_qwk_mdallbars.Device_Error_Code	asym_qwk_mdallbars_Device_Error_Code
asym_qwk_mdallbarsavg.Device_Error_Code	asym_qwk_mdallbarsavg_Device_Error_Code
asym_qwk_mdallpmtavg.Device_Error_Code	asym_qwk_mdallpmtavg_Device_Error_Code
asym_qwk_md1barsum.Device_Error_Code	asym_qwk_md1barsum_Device_Error_Code
asym_qwk_md2barsum.Device_Error_Code	asym_qwk_md2barsum_Device_Error_Code
asym_qwk_md3barsum.Device_Error_Code	asym_qwk_md3barsum_Device_Error_Code
asym_qwk_md4barsum.Device_Error_Code	asym_qwk_md4barsum_Device_Error_Code
asym_qwk_md5barsum.Device_Error_Code	asym_qwk_md5barsum_Device_Error_Code
asym_qwk_md6barsum.Device_Error_Code	asym_qwk_md6barsum_Device_Error_Code
asym_qwk_md7barsum.Device_Error_Code	asym_qwk_md7barsum_Device_Error_Code
asym_qwk_md8barsum.Device_Error_Code	asym_qwk_md8barsum_Device_Error_Code
asym_qwk_md9barsum.Device_Error_Code	asym_qwk_md9barsum_Device_Error_Code
asym_qwk_md1neg.Device_Error_Code	asym_qwk_md1neg_Device_Error_Code
asym_qwk_md2neg.Device_Error_Code	asym_qwk_md2neg_Device_Error_Code
asym_qwk_md3neg.Device_Error_Code	asym_qwk_md3neg_Device_Error_Code
asym_qwk_md4neg.Device_Error_Code	asym_qwk_md4neg_Device_Error_Code
asym_qwk_md5neg.Device_Error_Code	asym_qwk_md5neg_Device_Error_Code
asym_qwk_md6neg.Device_Error_Code	asym_qwk_md6neg_Device_Error_Code
asym_qwk_md7neg.Device_Error_Code	asym_qwk_md7neg_Device_Error_Code
asym_qwk_md8neg.Device_Error_Code	asym_qwk_md8neg_Device_Error_Code
asym_qwk_md9neg.Device_Error_Code	asym_qwk_md9neg_Device_Error_Code
asym_qwk_md1pos.Device_Error_Code	asym_qwk_md1pos_Device_Error_Code
asym_qwk_md2pos.Device_Error_Code	asym_qwk_md2pos_Device_Error_Code
asym_qwk_md3pos.Device_Error_Code	asym_qwk_md3pos_Device_Error_Code
asym_qwk_md4pos.Device_Error_Code	asym_qwk_md4pos_Device_Error_Code
asym_qwk_md5pos.Device_Error_Code	asym_qwk_md5pos_Device_Error_Code
asym_qwk_md6pos.Device_Error_Code	asym_qwk_md6pos_Device_Error_Code
asym_qwk_md7pos.Device_Error_Code	asym_qwk_md7pos_Device_Error_Code
asym_qwk_md8pos.Device_Error_Code	asym_qwk_md8pos_Device_Error_Code
asym_qwk_md9pos.Device_Error_Code	asym_qwk_md9pos_Device_Error_Code
asym_qwk_pmtonl.Device_Error_Code	asym_qwk_pmtonl_Device_Error_Code
asym_qwk_pmtltg.Device_Error_Code	asym_qwk_pmtltg_Device_Error_Code
asym_qwk_pmtled.Device_Error_Code	asym_qwk_pmtled_Device_Error_Code
asym_qwk_isourc.Device_Error_Code	asym_qwk_isourc_Device_Error_Code
asym_qwk_cagesr.Device_Error_Code	asym_qwk_cagesr_Device_Error_Code
asym_qwk_preamp.Device_Error_Code	asym_qwk_preamp_Device_Error_Code
asym_qwk_linephase.Device_Error_Code	asym_qwk_linephase_Device_Error_Code
diff_qwk_raster_x.Device_Error_Code	diff_qwk_raster_x_Device_Error_Code
diff_qwk_raster_y.Device_Error_Code	diff_qwk_raster_y_Device_Error_Code
diff_qwk_raster_sumxy.Device_Error_Code	diff_qwk_raster_sumxy_Device_Error_Code
asym_dslumi_sum.Device_Error_Code	asym_dslumi_sum_Device_Error_Code
asym_dslumi_odd.Device_Error_Code	asym_dslumi_odd_Device_Error_Code
asym_dslumi_even.Device_Error_Code	asym_dslumi_even_Device_Error_Code
asym_qwk_dslumi1.Device_Error_Code	asym_qwk_dslumi1_Device_Error_Code
asym_qwk_dslumi2.Device_Error_Code	asym_qwk_dslumi2_Device_Error_Code
asym_qwk_dslumi3.Device_Error_Code	asym_qwk_dslumi3_Device_Error_Code
asym_qwk_dslumi4.Device_Error_Code	asym_qwk_dslumi4_Device_Error_Code
asym_qwk_dslumi5.Device_Error_Code	asym_qwk_dslumi5_Device_Error_Code
asym_qwk_dslumi6.Device_Error_Code	asym_qwk_dslumi6_Device_Error_Code
asym_qwk_dslumi7.Device_Error_Code	asym_qwk_dslumi7_Device_Error_Code
asym_qwk_dslumi8.Device_Error_Code	asym_qwk_dslumi8_Device_Error_Code
asym_uslumi_sum.Device_Error_Code	asym_uslumi_sum_Device_Error_Code
asym_uslumi1_sum.Device_Error_Code	asym_uslumi1_sum_Device_Error_Code
asym_uslumi3_sum.Device_Error_Code	asym_uslumi3_sum_Device_Error_Code
asym_uslumi5_sum.Device_Error_Code	asym_uslumi5_sum_Device_Error_Code
asym_uslumi7_sum.Device_Error_Code	asym_uslumi7_sum_Device_Error_Code
asym_qwk_uslumi1neg.Device_Error_Code	asym_qwk_uslumi1neg_Device_Error_Code
asym_qwk_uslumi3neg.Device_Error_Code	asym_qwk_uslumi3neg_Device_Error_Code
asym_qwk_uslumi5neg.Device_Error_Code	asym_qwk_uslumi5neg_Device_Error_Code
asym_qwk_uslumi7neg.Device_Error_Code	asym_qwk_uslumi7neg_Device_Error_Code
asym_qwk_uslumi1pos.Device_Error_Code	asym_qwk_uslumi1pos_Device_Error_Code
asym_qwk_uslumi3pos.Device_Error_Code	asym_qwk_uslumi3pos_Device_Error_Code
asym_qwk_uslumi5pos.Device_Error_Code	asym_qwk_uslumi5pos_Device_Error_Code
asym_qwk_uslumi7pos.Device_Error_Code	asym_qwk_uslumi7pos_Device_Error_Code

